
{
  "blocks" : [[5,  1,  1,  5,  1,  1,  5 ],
              [0,  0,  2,  2,  2,  0,  0 ],
              [0,  4,  4,  4,  4,  4,  0 ],
              [7,  6,  6,  6,  6,  6,  7 ],
              [7,  6,  6,  6,  6,  6,  7 ],
              [0,  4,  4,  4,  4,  4,  0 ],
              [0,  0,  2,  2,  2,  0,  0 ],
              [5,  1,  1,  5,  1,  1,  5 ] ],
}
