


{
  "blocks" : [ [0,  0,  0,  1,  0,  0,  0 ],
               [0,  0,  1,  2,  1,  0,  0 ],
               [0,  3,  2,  1,  2,  3,  0 ],
               [3,  4,  1,  2,  1,  4,  3 ],
               [9,  10, 7,  8,  7,  10, 9 ],
               [0,  9,  8,  7,  8,  9,  0 ],
               [0,  0,  7,  8,  7,  0,  0 ],
               [0,  0,  0,  7,  0,  0,  0 ] ],
}
